10.ox
...........oo.
...........oo.
........o.o..o
...........oo.
............oo
o...o.....oo..
o.......oo....
........o.....
.....oo..o....
..............
